jmk: rrj zea eys yvc uxf mls rsa hde dow lyy goe ged bmm
bmm: gcg qbx
xnc: rnw sbs
pgt: xlb vqt pae
uso: iwh ieh cxy
rnw: wze ktf exc ovp hll
zmh: udm
yff: aoq bah uxz
kav: gcp ebg jij
juf: cjm sdo xhu mdm
tml: szz yvr owb wkn gpp pwf ijd bdk zqp xdp xyl lah mws idm nnl yve
rmm: wub ufw
nzn: uzh lti lor xhf
zea: qbx odi
oku: qlu lcz
oat: exc
vre: svg fze tqg mou
odi: nah fgr ahs fzy
onm: uyb azy wal
cxy: ovp hll exc wze
inw: nhx
tot: fuz dnc siq
ged: xms itg
wfn: ovp hll wze ktf
csr: pcp cux pdc uzj
hga: msg
pif: xhu cjm
pdc: qzp fhz gxv
jbl: hhu ihf phd
ces: yzm
nxp: vff tkg upi
von: siz mco swd xiv
ewd: php spc
qru: zil
sdu: vbz fbm tmb
dwo: flm
abq: mno zuv jhp
mnw: kwl xpe
prl: gxv fhz qzp
kgl: idb
iwh: ovp ktf
pop: qee alo deh hae
fwv: cye uov
apz: lyt tnk
xcj: uzj pdc
ser: qzp fhz gxv
lyt: daz
wio: wal uyb ysz azy
bbo: kzb cbu
dhh: bkf gps
mgn: yff iyc
yhq: bld fpt
ofw: daz tml
fbm: kig
dol: cas eqq
fgl: sdo mdm
qcr: zeb jhp zuv ctf
lqy: bld
flm: syl avf wli qof dib wgw qok vjg ilh mwb ymn oku qce
sff: sjb
uux: rnw aqw
nfo: lba jdq yzm
zir: eqq
ngm: ink mir zzf
gps: mkr
mkr: cqd num
tfz: cas flm eqq
kve: lnh awu yiw
rtp: ygt xyt
vkj: xhu
akj: fhz
vjg: qcr heo
xyn: zzf mir
dev: tuw mkc
lcz: oor rvi
wjq: fhz qzp
mwc: lwp
afx: gkt doi ewd
yiw: tml daz
vws: gps inw
umw: rri
xmw: jyy lkt lcm vre cbh
bod: dnc fuz
qof: qlu lcz
ouj: htv akn
vqp: npz
ilh: rhs nmu
ivv: rdf awu lnh
eei: htv iij
mwb: lfu kjx
lah: wlo sya jco qoc
awu: you ngs
fux: fyl
rnv: oou zou vlv vqy oat
gga: jbl
ehz: ktf ovp
fgu: yff dvx iyc
dtd: nmr dit ybe mwy has
rhs: lff mgn fgu fft nsa
sdw: dnc fuz siq
ece: tml you ngs daz
sbs: exc hll
vff: dev int kwn rim
dit: flm eqq
fzy: hll ovp exc ktf
gso: xpe ttv wrl
zpt: cux pcp uzj pdc
zsa: boe hjo fiu mci
hyq: jmk sdo xhu
vjw: tca
qnx: dba
yzm: nvo
tal: dyq
kig: cas eqq
hqe: oqz ser
jhq: gzx ham oue
uyb: yyt nxv
vxe: udm
lkt: fwg svg fze tqg
eza: vqp pae qfq
ccq: rvi oor
xlb: zgc dtd npz yzg
xms: cxy
lcm: fze mou fwg svg
qok: lcz
vlv: hll exc
xok: upi fbe vff qul
cfl: xmw asw dgh
bdk: siz bej xiv
ovn: hjo boe
lwp: daz tml
msj: ooe fgl pif usk ove
xki: xcj zga csr
dnb: gxv
deh: oze fyn
tuw: eqq
wal: yyt
lti: cqb jzf
fhz: okh gxk skd hyh duy njo dui bjv wfx tic znq
uov: bbo
bzk: jjo ijm dba
ocy: nys wek tvg vjd
kkv: deh
iij: qnv gsq
mci: tzp gsc nno
yzg: mwy has nmr ybe
vjd: out
cpn: pxn qru tal ssz
rdf: ngs
sdk: xnc znn jgs
sqt: smw cto
pcp: gxv
cto: ngs
hyh: msg nth
qoc: vyy suh
llf: lor
cbj: ovl knw cog
fpo: ham
rvi: wsj wjq exz nuz wzl
dti: xhf uzh lti
xpm: csr kgl zpt
ooe: cjm jmk xhu sdo
duy: tvz cye
ove: sdo
gdm: mnw gso emb
qcv: tkg vff fbe upi
cbu: sdo jmk
mou: zos zir jbk
gpp: joe jah eei
fze: jbk
cqd: rqs itk
zga: cux pdc uzj
ink: ptj vxe zmh iew
dug: xcz mwc cif zmo cbj
ham: kkc ppr fux
phi: qru tal rtw ssz
aoq: qzp gxv
jxk: hae qee alo deh
jdq: nvo tha phl
gcg: fzy ahs nah
xrk: ebg jij eza gcp pgt
fep: boe mci
eup: ygt xyt
kxs: you daz
siq: ngq png rmy
qte: pgq kft waw sjb
rmy: sdo mdm xhu cjm
cas: wgw qof oop wli avf mwb nvp ilh vjg bdv oku ymn vqw xgd qce
has: eqq cas
cif: cog ovl
lki: out
ufw: goo kxs lvw
bej: jpv
nnb: iij
ert: yue fhl pgr
tgh: xcj kgl
ovp: tet pgi cmk gdt nzn phi uoj rjd xmg bxr dti
dbf: cjm jmk xhu mdm
tav: yzm lba jdq
nmg: cuo
lqc: jyy vre cbh
mws: vws dhh nit
skd: uov tvz
bah: qzp
rvv: gkt
ymn: abq qcr
joe: iij akn htv
kwl: out
vqw: vcq
dla: exc
bdv: nmu rhs
lfu: ujd xki tgh
lba: qfy nvo tha phl
mhs: kzb cbu
bfg: lyt ofw
bld: iqb gnq gaj pix vlt
qul: rim int
vpe: tot
vyy: dgp gga syd ewi
syl: abq
yyt: hen isy tfz
nuz: fhz
fpt: gaj vlt
mgx: wub nlm ufw
dui: tvz uov
qbx: laf nah
oor: exz nuz wjq wsj
ovl: tml
ckk: sff gcd qte bct
azy: nxv wye
bsk: hae deh qee alo
iwi: out
fyn: fon
gbj: lpn uxw
rtw: zil
sya: vyy suh
ebg: vqt xlb vqp qfq
tkg: int dev
ngs: yve nnl idm vjp zqp mws xyl gpp dsu wkn bdk owb yvr
vqy: wze
fft: yff iyc dvx
jhp: wsd ert opw
hae: oze
tha: mvl rnv
tjl: nxv
iyc: aoq prl qhw
coc: hhu ihf
axp: jhj rmo ptn
bet: mdm sdo cjm
qcn: cas
fnk: znn jgs xnc
bjv: rvv bhb
ihf: out
fhl: fhz qzp
wlo: jdt
yue: qzp
yvs: kzb vkj
qlu: fta rvi pmj
eon: rvv bhb
exq: cas flm eqq
xyl: nit
xdz: pix gaj gnq vlt
jco: suh vyy
vql: out
hve: ijm
gsq: emt oed mnw
sjm: vbz tmb
ijd: aln bhn
phd: out
kjx: xpm xki tgh
tqg: zos jbk
nlm: kxs
tvz: aip bbo yvs
bct: kft
xvo: eup rtp
tzp: usk fgl
hce: apz hyd
whl: doi
dvx: uxz qhw bah prl aoq
mcd: rmm gmd bec
tca: lff fgu mgn fft
ujd: csr zpt xcj zga
swd: okt mfj jpv
ieh: exc hll
yeg: fon exq dol
pce: jjo pkh dba
qjx: sdw tot
zwf: deh alo qee hae ayx
gxv: hyh eon hga zsa fep gxk qjx mal dui nue fwv
xmg: uxw ckk
qee: yeg oze
siz: okt
nsa: iyc
jjo: btg lnw
fiu: tzp nno gwh msj
num: yvf itk iwi
hde: yzm jdq
mny: gxv
rjd: ojc
hhu: out
fgr: exc hll ktf
gxk: eup
bkf: nhx jjp
zmo: ovl muq lwp knw cog
uty: rbs lqy yhq cgk
jhj: ktf wze ovp hll exc
znq: nth
hll: ldv cmk phi nzn xbh mjo dti bxr mcd
jij: pae xlb
asw: lcm
oea: gxv fhz
nah: exc ktf wze
cbh: svg fwg mou fze
kkc: dla kfq ehz
hed: dhq
ptn: exc ovp wze
fbe: kwn dev int
cuo: vjd wek nys
pwf: ouj jah nnb joe
ftx: gbh dyu
yhr: qwh smw
nhx: num okg lhf cqd
pgr: fhz qzp gxv
cjm: ged wsq bmm dow lyy ywy goe mls uxf gon hde rrj nfo ces fpo zea hed eys yvc
dhq: uux xnc jgs
htv: gdm gsq
nmu: lff fgu fft
xhu: hqx dow ged wsq bmm ces fpo jhq yvc hde uxf rsa
php: cjm sdo mdm
cog: tml you ngs
goe: gzx
dib: pce hve cni bzk qnx
rim: ssc mkc
gnm: out
wfx: eup
wzl: fhz qzp
cqb: cif xcz cbj
gwh: pif
wub: lvw goo
nys: out
skr: zwf ftx wio ilq sdu pop cfl fyc hqr xrk xok bsk ogq poy pqs bbr ovm jxk sjm nxp
akn: gdm gsq qnv
rmo: exc ktf
doi: fhk spc bet
nit: inw
cpg: ebg pgt gcp eza
mno: ert
ovm: gbh dyu fbm vbz tmb
rqs: out
uit: out
npz: has mwy ybe nmr
ygt: jmk sdo mdm
ufg: ptn jhj rmo
oue: kkc fux ppr
vym: hhu
srt: joe
idm: xiv mco siz bej swd
wsq: ufg lsv axp
yaf: vjd
vqt: dtd
xhf: jzf
dyq: luk yhr lir
dac: luk yhr sqt
vbe: cjm
nue: rtp ycy
you: idm nnl vjp xdp lah xyl wkn dsu ijd szz owb
iqb: lki uit
poy: uyb
yvc: srw xms mwj uso itg
kwn: tuw fut ssc mkc
ywy: ufg
rsa: itg uso srw xms
zeb: ert wsd
wwg: ngs you
dsu: dhh
fon: flm
okg: rqs
njo: sdw bod
yvr: jah
mvl: vlv oat
xbh: kxl bfg hyd
lyy: qbx gcg
jzf: xcz zmo cif cbj
ssc: flm
ogq: azy uyb ysz tjl
ybe: flm
bec: nlm bwp ufw
lff: yff dvx iyc
gcd: waw sjb kft
xcz: lwp muq knw cog
lor: cqb
jbk: cas
exc: dti rjd hce gbj uoj nzn upu gdt itx ldv pgi ngm bxr mcd mjo xmg cpn xbh xyn yzs cmk llf
avf: cni bzk qnx
phl: rnv mvl
oqz: gxv qzp
xpe: out
szz: sya wlo bad qoc
uoj: hyd bfg
okh: ycy
aln: rbs lqy yhq cgk
wrl: out
bkj: hyq
hjo: tzp msj gwh
xiv: mfj umw okt
ayx: yeg
knw: daz you
pae: yzg npz zgc
uxf: oue gzx ham
nvp: pce
cgk: xdz
rrj: axp lsv
vjp: vws
nxv: hen
emb: kwl
pgi: uxw
nnl: vws
kzb: cjm jmk mdm xhu
mls: gcg odi qbx
gzx: kkc fux
mfj: nmg
eys: yzm
pkh: btg lnw
ssz: dac dyq
smw: tml you
tmb: qcn kig
nth: juf vbe hyq
upi: int
hqr: pgt eza jij
lnh: daz tml
mwy: cas flm
gcp: pae xlb vqt
eqq: qok wgw ykp oku vqw syl avf mwb nvp vjw
oou: ovp
wsd: mny pgr fhl yue
svr: skr ujw iby
heo: mno ctf zuv
gnq: gnm lki
xmo: ngs you tml
sdo: rsa uxf bmm gon lyy rrj goe hed jhq ywy
emt: wrl xpe kwl vql
fuz: rmy
dba: btg
wgw: hve bzk cni
cux: fhz gxv
pxn: dyq zil dac
ewi: vym jbl coc
wze: cmk mcd bxr cpn xmg uoj nzn ldv itx dti hce rjd xyn xbh phi tet llf yzs mjo gdt upu pgi ngm gbj
oed: ttv xpe
mir: dhp ptj vxe iew
fta: wzl exz nuz wjq
hen: eqq
bhb: gkt ewd
jyy: mou tqg fze svg fwg
jah: htv iij
jgs: rnw
gmd: nlm
wek: out
spc: jmk sdo mdm xhu
cni: jjo ijm pkh dba
vtd: ovp exc hll wze
idb: fhz qzp
usk: jmk mdm xhu sdo
btg: dnb oea ser
ijm: btg hqe
vcq: tgh ujd
qfq: npz yzg zgc
itg: iwh ieh
zos: eqq cas flm
uzh: jzf dug
isy: cas
gdt: gmd bec mgx rmm
lir: smw
fyl: wze exc hll ovp
boe: nno
ktf: rjd hce bxr ngm llf pgi upu xyn
png: jmk cjm sdo
qhw: gxv fhz
dnc: ngq
qwh: daz ngs tml
pgq: wwg xmo
bbr: fbe upi qul
mkc: cas
oze: dol
mjo: ckk
pmj: wzl nuz
dow: fnk
wye: dwo
zuv: ert wsd opw
exz: qzp fhz
hyd: lyt ofw tnk
ttv: out
ojc: dug
oss: eqq cas
cye: yvs mhs aip
ykp: vcq
lhf: yvf
nmr: cas flm
ycy: dbf ygt xyt
lnw: oqz oea dnb
alo: yeg fyn
qmd: cas
wsj: gxv
fhk: jmk xhu
goo: tml you daz
aip: kzb
tvg: out
qzp: okh skd gxk duy tic jqc ovn znq fwv nue mal bjv dui eon hga xvo vpe hyh zsa
gkt: fhk umd
ctf: ert wsd opw
tnk: ngs you tml
rri: ocy cuo ecw yaf
uzj: qzp
bwp: lvw
xdp: qoc jco wlo
nvo: mvl
luk: cto smw
srw: vtd
ldv: uzh lor
znn: aqw sbs rnw
dhp: kve ivv udm
daz: owb pwf gpp von yve ijd srt
xgd: heo qcr
laf: ovp
xzl: flm
vlt: lki
iby: kav pqs ogq jxk bbr xrk wio cfl cpg sdu poy qcv bsk sjm ovm onm hqr kkv fyc xok ilq ftx zwf pop
gaj: onr lki gnm
jqc: afx whl rvv
mdm: goe ywy hqx bmm wsq eys yvc ces zea jhq nfo rrj hde gon tav uxf rsa
pix: gnm
kfq: ktf wze ovp
fut: eqq flm cas
ecw: wek nys
dyu: xzl
dgh: lkt vre cbh
zqp: xiv siz mco swd
jjp: okg lhf cqd num
owb: wlo sya qoc
svg: jbk zir
cmk: ssz rtw pxn qru
fwg: jbk zos
sjb: ece xmo
kxl: ofw lyt
ptj: udm ivv kve
lsv: jhj ptn
opw: pgr akj mny
ngq: mdm
fyc: dgh xmw lqc
rbs: fpt xdz
ujw: sjm ovm qcv poy bsk pop ilq zwf ftx xok onm kkv fyc hqr jxk bbr pqs ogq kav cpg cfl sdu wio xrk
qnv: emb mnw emt oed
qfy: ctw mvl
udm: lnh awu yiw rdf
itk: out
gbh: qcn xzl oss kig
nno: ove ooe
kft: xmo ece wwg
jdt: ewi
mal: bkj
qce: kjx
itx: ink zzf mir
tic: afx
zag: ecw
lpn: qte gcd
iew: udm ivv
zzf: dhp vxe iew
aqw: exc hll ovp ktf
vbz: kig
yzs: rtw ssz tal qru pxn
ilq: tjl azy
bad: jdt suh
zgc: has mwy dit ybe nmr
bhn: yhq
upu: gmd bec
zou: ktf exc hll
oop: qlu
mco: mfj okt
gsc: ooe fgl ove pif
dgp: vym
muq: ngs
okt: zag
syd: coc jbl
lvw: ngs daz you
bxr: uxw
yvf: out
waw: wwg
jpv: zag nmg
ahs: wze ktf ovp exc
wkn: uty aln bhn
uxz: fhz gxv
tet: apz
mwj: iwh
msg: vbe juf hyq
ppr: dla wfn kfq fyl
umd: xhu sdo jmk
zil: lir sqt
onr: out
pqs: lqc xmw asw
yve: aln
uxw: sff bct
int: mkc ssc fut qmd
xyt: cjm xhu sdo
ctw: oat vlv vqy oou
hqx: dhq sdk
gon: lsv oxm
wli: ccq
suh: syd
oxm: ptn
ysz: yyt wye
